       NO ./assets/texture/north_texture.xpm
SO ./assets/texture/south_texture.xpm
WE ./assets/texture/west_texture.xpm
EA ./assets/texture/east_texture.xpm

F 0,0,0
C 0,0,0

1111111111111
1000000000001
1000000000001
100000N000001
1000000000001
1000000000001
1111111111111
