NO ../texture/
SO ../texture/
WE ../texture/
EA ../texture/

F 0,0,0
C 0,0,0

111111111111111111111111111111111
100000000011000000000000000000001
101100000111000000000000000000001
100100000000000000000000000000001
111111111011000001110000000000001
100000000011000001110111111111111
11110111111111011100000010001
   10111111111011101010010001
1 110000110101011100000010001
11100000000000001100000010001
10000000000000001101010010001
11000001110101011111011110N0111
11110111 1110101 101111010001
11111111 1111111 111111111111
