       NO ./assets/texture/north_texture.xpm
SO ./assets/texture/south_texture.xpm
WE ./assets/texture/west_texture.xpm
EA ./assets/texture/east_texture.xpm

F 0,0,0
C 0,0,0

         111111111  11111111111111
         100000001  10000000000001
       111011000011110000000000001
         1001000000000000000000001
1111111111011000001100000000000001
1111000000011000001110111111111111
   11010111111111001100000111    
   110101111110111010100101
111100001101010111000000101111
100000000000000011000N0010111
100000000000000011010100100001
110000011111111111110111100111
11110111   11111 101111010001
11111111   11111 111111111111