NO ../texture/
SO ../texture/
WE ../texture/
EA ../texture/

F 0,0,0
C 0,0,0

         1111111111111111111111111
         1000000000110000000000001
       111011000001110000000000001
         1001000000000000000000001
1111111111011000001100000000000001
1111000000011000001110111111111111
   11010111111111011100000111    
   110101111110111010100101
111100001101010111000000101111
10000000000000001100000010111
10000000000000001101010010001
11000001111111111111011110N0111
11110111   11111 101111010001
11111111   11111 111111111111