SO ./assets/texture/south_texture.xpm
       NO ./assets/texture/north_texture.xpm
WE ./assets/texture/west_texture.xpm
EA ./assets/texture/east_texture.xpm

C 205,249,101
F 157,157,157

1000000000001
1000000000001
1000000000001
1000000000001
100000N000001
1000000000001
1000000000001
1000000000001
1000000000001
1111111111111
