SO ./assets/texture/south_texture.xpm
       NO ./assets/texture/north_texture.xpm
WE ./assets/texture/west_texture.xpm
EA ./assets/texture/east_texture.xpm

C 205,249,101
F 157,157,157

111111111111
100000000000
100000000000
100000000000
100000000000
100000N00000
100000000000
100000000000
100000000000
100000000000
111111111111
