SO ./assets/texture/south_texture.xpm
       NO ./assets/texture/north_texture.xpm
WE ./assets/texture/west_texture.xpm
EA ./assets/texture/east_texture.xpm

C 205,249,101
F 157,157,157

111111111111
000000000001
000000000001
000000000001
000000000001
00000N000001
000000000001
000000000001
000000000001
000000000001
111111111111
